#######
##E## #
##    #
##E S##
### ###