#######
##S## #
##    #
##   ##
### ###
