######
##S###
##   #
## E##
#######
