######
##S###
##   #
## E##
######
#