#######
##E## #
##    #
##S S##
### ###