#######
##E## #
##    #
##   ##
### ###